Starpusher : 






Niveaux 1 :


########
#      #
# .$@  #
#      #
#  .   #
#  $   #
########






Niveaux 2 : 


########
#      #
# @$ $ #
#   .  #
#   .  #
#      #
########










Niveaux 3 : 




########
#  b   #
# .$@$.#
#      #
#   d  #
########






Niveaux 4 : 
########
# $ .  #
# @#   #
# $ .  #
#      #
########








Niveaux 5 : 


##########
#   b    #
# @ $$ . #
#   .    #
#  $d .  #
##########






Niveaux 6 : 
##########
#  b     #
# @$.$.$ #
#   .    #
# $  d   #
##########


Niveaux 7 : 


#########
#   b   #
# $@$.$ #
#   #   #
# .$ .$ #
#   d   #
#########






Niveaux 8 :
 
#########
#   .   #
# $.$.$ #
#   #   #
#   @   #
#   b   #
#   d   #
#########